
// Sep, 9
ja = да
jawohl = да, конечно
nein = нет

was = что
wer = кто
wie = как
wieviel = сколько

ich = я
du = ты
er = он
sie = она, они
wir = мы
Sie = Вы

der Tag = день
die Tage = дни
Guten Tag = добрый день
auf Wiedersehen = до свидания
der Morgen = утро
die Nacht = ночь
der Abend = вечер


// Sep, 10
sein = быть
essen = есть
trinken = пить
gehen = ходить
haben = иметь
arbeiten = работать
fahren = ехать
geben = давать
helfen = помогать
kaufen = покупать
können = мочь
lernen = учиться
lesen = читать
lieben = любит
machen = делать
reden = разговаривать
schlafen = спать
suchen = искать
waschen = мыть
warten = ждать
